H333333333333333333333333333333H
H******************************H
H******************************H
H******************************H
H******************************H
H******************************H
H******************************H
H******************************H
H******************************H
H******************************H
H******************************H
H******************************H
H******************************H
H******************************H
H******************************H
H******************************H
H******************************H
H******************************H
H******************************H
H******************************H
H******************************H
H******************************H
H888888888888888888888888888888H
H333333333333333333333333333333H