NMMMMMMMMMMMMMMMMMMMMMMMMMMMMMMMMMMMMMMMMMMMMMMMM!
@666789qw6666666666666789qw666666666666789qw66666*
@66ertyui666666666666ertyui66666666666ertyui66666*
@66opasdf666666666666opasdf66666666666opasdf66666*
@66ghjklz666666666666ghjklz66666666666ghjklz66666*
@66xcvbnm666666666666xcvbnm66666666666xcvbnm66666*
@66QWERTY666666666666QWERTY66666666666QWERTY66666*
@66UIOPAS666666666666UIOPAS66666666666UIOPAS66666*
@66DFGHJK666666666666DFGHJK66666666666DFGHJK66666*
@66LZXCVB666666666666LZXCVB66666666666LZXCVB66666*
@666666666666666666666666666666666666666666666666*
@666666666666666666666666666666666666666666666666*
@666666666666666666666666666666666666666666666666*
@666666666666666666666666666666666666666666666666*
@666666666666666666666666666666666666666666666666*
@-_____________________6666_____________________=*
@.1666666666666666666666666666666666666666666661.*
@.6666666666666666666666666666666666666666666666.*
@.6666666666666666666666666666666666666666666666.*
@.6666666666666666666666666666666666666666666666.*
@.6666666666666666666666666666666666666666666666.*
@.4666666666666666666666666666666666666666666664.*
@.4666666666666666666666666666666666666666666664.*
@.6666666666666666666666666666666666666666666666.*
@.6666666666666666666666666666666666666666666666.*
@.6666666666666666666666666666666666666666666666.*
@.6666666666666666666666666666666666666666666666.*
@.1666666666666666666666666666666666666666666661.*
@/;;;;;;;;;;;;;;;;;;;;;;;;;;;;;;;;;;;;;;;;;;;;;;'*
%^^^^^^^^^^^^^^^^^^^^^^^^^^^^^^^^^^^^^^^^^^^^^^^^&